1111111111111111111
1P00000X000000C0001
1001111111111000001
100X0000000X0000001
10000X1111100000001
1000011111111000001
100001100011C000001
1X0001100001100X001
100000000000000E001
1111111111111111111