1111111
1P00001
1X0C0X1
100E001
1111111