1111111111111
1P0X0X0X00C01
1000000000001
100000E000001
1111111111111