111111111111111111111
1P000000000000000C001
100000000000000000001
100000000000000000001
100000C00000C0000C001
100000000000000000001
100000000000000000001
100000000000000000001
100000C00000000000001
100000000000000000001
100000000000000000001
10000000000000000C001
1000000000000000000E1
111111111111111111111
