1111111111111
1C0C000C00C01
1C00C11C11C01
1P0C11E11C001
1C0C000C00C01
1111111111111
