111111111111111
1P000111000C001
111010101111101
100000101000C01
101111101011111
1C0000000000001
111111011111101
1000C0000000C01
101110111011101
100010001010001
1C0010C01010E01
111111111111111
