1111111111111
1P01000000C01
1000011111001
1P0011E000001
1111111111111
