1111111111111
1E01000000C01
1000011111001
1P001100000E1
1111111111111