1111111111111
1P0X000000C01
1000011111001
100011E000001
1111111111111