1111111111111
1P00000111001
1111100111001
1000C00111001
1011111110001
1000000000C01
1011111111101
1000C0000E001
1111111111111
