1111111111111
1P01000000C01
1000011111001
1000111E11001
1111111111111
