1111111111111
1P00000000C01
1000000000001
1X0000E0000X1
1111111111111